################
#S         # & #
####       #   #
#       ####   #
#  #      ##   #
#  #  ###      #
#  #  #   ######
#  #  #   #   X#
#  # ## ####2###
#%       1     #
################
5
2%
1&

