################
#S         #   #
####       #   #
#       ####   #
#  #      ##   #
#  #           #
#  #  #   ######
#  #  #   #   X#
#  #### ####2###
#%             #
################
5
2%

